20 11
111111011111111111111
100011200011111111111
101011110011111111111
100000000011111111111
101111111111111111111
101111111111111111111
100000000011111111111
111101111011111111111
111110000011111111111
111110111111111111111
111110111111111111111